FIRST_IMPACT_MAP
1
20
20
1
0
0 10 10 0 10 0 10 10 10 0 10 10 0 0 10 10 0 10 0 10
10 10 10 10 10 10 10 10 10 10 10 10 0 10 10 0 0 10 0 10
10 10 10 10 10 0 0 0 10 10 0 10 10 10 0 0 2 0 0 0
10 10 0 10 0 10 10 10 10 10 10 10 10 0 0 0 1 0 0 10
10 10 10 10 10 10 10 0 10 10 10 10 0 0 0 0 1 0 10 0
10 10 10 10 10 10 10 10 10 10 0 0 0 0 0 0 1 0 0 10
0 10 10 10 10 10 10 0 0 0 0 0 0 0 0 0 1 0 10 10
0 10 10 0 0 10 10 0 0 1 1 1 1 0 0 0 1 0 0 10
10 10 10 0 0 10 10 0 0 1 0 0 1 1 0 1 1 0 0 10
10 10 10 10 10 0 10 0 0 3 0 0 0 1 1 1 0 0 10 10
10 10 0 0 0 10 0 0 0 1 0 10 0 0 0 0 0 10 0 10
10 0 0 1 1 1 0 1 1 1 0 10 0 0 10 10 10 10 10 10
10 0 0 1 0 1 1 1 0 0 0 0 10 10 10 0 10 0 10 10
10 0 10 1 0 0 0 0 0 0 0 10 10 10 10 10 10 10 10 10
10 0 0 1 0 0 0 10 0 10 0 0 0 10 0 10 10 10 10 10
10 10 0 1 0 10 0 0 10 10 10 0 10 10 10 10 10 0 10 10
0 0 0 1 0 0 10 10 0 0 10 10 10 10 10 10 0 0 10 0
10 0 0 1 0 0 0 10 0 0 10 10 10 10 10 0 10 10 10 10
0 10 0 2 0 10 10 10 10 10 0 10 0 10 10 10 10 10 10 10
0 0 0 0 10 10 10 10 10 0 0 0 0 0 0 0 10 10 10 0
0 0 0 0 0 0 0 0 0 0 0 0 0 0 0 0 0 0 0 0
0 0 0 0 0 0 0 0 0 0 0 0 0 0 0 0 0 0 0 0
0 0 0 0 0 0 0 0 0 0 0 0 0 0 0 0 0 0 0 0
0 0 0 0 0 0 0 0 0 0 0 0 0 0 0 0 0 0 0 0
0 0 0 0 0 0 0 0 0 0 0 0 0 0 0 0 0 0 0 0
0 0 0 0 0 0 0 0 0 0 0 0 0 0 0 0 0 0 0 0
0 0 0 0 0 0 0 0 0 0 0 0 0 0 0 0 0 0 0 0
0 0 0 0 0 0 0 0 0 0 0 0 0 0 0 0 0 0 0 0
0 0 0 0 0 0 0 0 0 0 0 0 0 0 0 0 0 0 0 0
0 0 0 0 0 0 0 0 0 0 0 0 0 0 0 0 0 0 0 0
0 0 0 0 0 0 0 0 0 0 0 0 0 0 0 0 0 0 0 0
0 0 0 0 0 0 0 0 0 0 0 0 0 0 0 0 0 0 0 0
0 0 0 0 0 0 0 0 0 0 0 0 0 0 0 0 0 0 0 0
0 0 0 0 0 0 0 0 0 0 0 0 0 0 0 0 0 0 0 0
0 0 0 0 0 0 0 0 0 0 0 0 0 0 0 0 0 0 0 0
0 0 0 0 0 0 0 0 0 0 0 0 0 0 0 0 0 0 0 0
0 0 0 0 0 0 0 0 0 0 0 0 0 0 0 0 0 0 0 0
0 0 0 0 0 0 0 0 0 0 0 0 0 0 0 0 0 0 0 0
0 0 0 0 0 0 0 0 0 0 0 0 0 0 0 0 0 0 0 0
0 0 0 0 0 0 0 0 0 0 0 0 0 0 0 0 0 0 0 0
