FIRST_IMPACT_MAP
1
20
20
2
0
10 0 10 0 10 0 10 0 0 0 10 10 10 10 10 10 0 0 10 0
10 10 10 10 0 10 0 10 10 10 0 10 0 10 10 0 10 10 0 0
10 10 0 0 10 0 10 10 10 0 10 0 10 10 10 10 10 10 10 10
0 10 0 0 10 10 10 10 0 10 0 12 0 0 0 10 10 0 10 10
10 0 10 10 0 0 0 0 0 0 0 10 10 10 10 10 10 0 10 0
0 10 10 0 0 2 1 1 1 0 0 0 0 0 0 10 10 10 10 10
10 0 0 0 0 0 0 0 1 0 0 0 0 0 10 0 0 10 0 10
10 0 0 11 11 11 11 4 1 5 0 8 0 0 0 0 0 0 10 0
10 0 2 1 1 1 1 1 1 1 1 1 1 1 1 1 3 0 0 10
0 0 0 11 11 11 11 0 6 0 7 0 12 0 0 10 0 0 10 0
10 0 10 0 0 0 0 0 0 0 0 0 0 10 0 0 0 10 0 10
0 0 0 10 0 10 0 0 0 0 10 0 0 0 0 0 0 0 10 10
10 0 0 0 0 0 0 10 0 0 0 0 0 10 10 10 10 10 0 10
0 10 10 10 0 0 10 10 10 0 10 10 10 0 0 10 0 10 10 0
10 10 10 10 10 10 0 0 10 10 10 10 0 0 0 10 10 0 10 10
10 0 0 0 10 10 10 10 10 0 10 0 10 10 10 10 10 10 10 10
10 10 0 10 10 0 0 10 0 0 10 10 10 10 0 0 0 10 0 0
0 10 10 10 10 10 10 0 10 10 10 10 10 10 10 0 0 0 0 10
10 10 0 0 10 10 10 10 10 10 10 10 10 10 10 10 10 0 0 10
0 10 10 10 10 10 10 10 0 0 0 0 0 0 0 0 10 10 0 0
0 0 0 0 0 0 0 0 0 0 0 0 0 0 0 0 0 0 0 0
0 0 0 0 0 0 0 0 0 0 0 0 0 0 0 0 0 0 0 0
0 0 0 0 0 0 0 0 0 0 0 0 0 0 0 0 0 0 0 0
0 0 0 0 0 0 0 0 0 0 0 0 0 0 0 0 0 0 0 0
0 0 0 0 0 0 0 0 0 0 0 0 0 0 0 0 0 0 0 0
0 0 0 0 0 0 0 0 0 0 0 0 0 0 0 0 0 0 0 0
0 0 0 0 0 0 0 0 0 0 0 0 0 0 0 0 0 0 0 0
0 0 0 0 0 0 0 0 0 0 0 0 0 0 0 0 0 0 0 0
0 0 0 0 0 0 0 0 0 0 0 0 0 9 0 0 0 0 0 0
0 0 0 0 0 0 0 0 0 0 0 0 0 0 0 0 0 0 0 0
0 0 0 0 0 0 0 0 0 0 0 0 0 0 0 0 0 0 0 0
0 0 0 0 0 0 0 0 0 0 0 0 0 0 0 0 0 0 0 0
0 0 0 0 0 0 0 0 0 0 0 0 0 0 0 0 0 0 0 0
0 0 0 0 0 0 0 0 0 0 0 0 0 0 0 0 0 0 0 0
0 0 0 0 0 0 0 0 0 0 0 0 0 0 0 0 0 0 0 0
0 0 0 0 0 0 0 0 0 0 0 0 0 0 0 0 0 0 0 0
0 0 0 0 0 0 0 0 0 0 0 0 0 0 0 0 0 0 0 0
0 0 0 0 0 0 0 0 0 0 0 0 0 0 0 0 0 0 0 0
0 0 0 0 0 0 0 0 0 0 0 0 0 0 0 0 0 0 0 0
0 0 0 0 0 0 0 0 0 0 0 0 0 0 0 0 0 0 0 0
